Göttingen north=Warendorf east=Worms west=Korbach south=Emmendingen
Meißen north=Erfurt east=Vechta west=Torgau south=Schwerin
Rostock north=Bielefeld east=Nuremberg west=Munich south=Ludwigsburg
Kronach north=Berlin east=Donauwörth west=Mindelheim south=Bonn
Husum north=Mindelheim east=Bonn west=Künzelsau south=Regensburg
Bonn north=Kronach east=Pirna west=Husum south=Tauberbischofsheim
Rotenburg north=Marburg east=Trier west=Coburg south=Cottbus
Erfurt north=Bad Reichenhall east=Marienberg west=Würzburg south=Meißen
Marienberg north=Peine east=Bad Segeberg west=Erfurt south=Vechta
Dortmund north=Wuppertal east=Wiesbaden west=Magdeburg
Munich north=Osnabrück east=Rostock west=Jena south=Brake
Donauwörth north=Hofeck east=Stralsund west=Kronach south=Pirna
Pirna north=Donauwörth east=Coburg west=Bonn south=Rosenheim
Coburg north=Stralsund east=Rotenburg west=Pirna south=Aichach
Düren north=Rosenheim east=Oldenburg west=Neustadt south=Kirchheimbolanden
Traunstein north=Hamburg east=Kitzingen south=Meiningen
Münster north=Siegen east=Düsseldorf west=Cham
Nuremberg north=Pirmasens east=Mindelheim west=Rostock south=Künzelsau
Ludwigsburg north=Rostock east=Künzelsau west=Brake south=Cologne
Kassel north=Gifhorn east=Heidelberg west=Worms south=Peine
Heidelberg north=Neustadt east=Kirchheimbolanden west=Kassel south=Görlitz
Hanau north=Freiburg west=Fürth south=Lübeck
Deggendorf north=Dresden west=Duisburg south=Ingolstadt
Worms north=Beeskow east=Kassel west=Göttingen south=Bad Reichenhall
Braunschweig north=Stuttgart east=Dingolfing west=Bad Segeberg south=Lüchow
Kitzingen north=Bremen east=Torgau west=Traunstein south=Potsdam
Bad Segeberg north=Görlitz east=Braunschweig west=Marienberg south=Wuppertal
Pirmasens east=Mainz west=Bielefeld south=Nuremberg
Cologne north=Ludwigsburg east=Regen west=Weißenburg south=Warendorf
Tauberbischofsheim north=Bonn east=Rosenheim west=Regensburg south=Neustadt
Dresden north=Trier west=Cottbus south=Deggendorf
Emmendingen north=Göttingen east=Bad Reichenhall west=Gießen south=Würzburg
Landsberg north=Torgau east=Schwerin west=Potsdam
Wiesbaden north=Lüchow east=Cham west=Dortmund
Kirchheimbolanden north=Düren east=Altchemnitz west=Heidelberg south=Stuttgart
Peine north=Kassel east=Görlitz west=Bad Reichenhall south=Marienberg
Bremen north=Gießen east=Würzburg west=Hamburg south=Kitzingen
Würzburg north=Emmendingen east=Erfurt west=Bremen south=Torgau
Torgau north=Würzburg east=Meißen west=Kitzingen south=Landsberg
Regensburg north=Husum east=Tauberbischofsheim west=Regen south=Gifhorn
Neustadt north=Tauberbischofsheim east=Düren west=Gifhorn south=Heidelberg
Oldenburg north=Aichach east=Duisburg west=Düren south=Altchemnitz
Osnabrück east=Bielefeld west=Essen south=Munich
Jena north=Essen east=Munich south=Hannover
Berlin east=Hofeck west=Mainz south=Kronach
Mindelheim north=Mainz east=Kronach west=Nuremberg south=Husum
Bergheim north=Hannover east=Weißenburg south=Karlsruhe
Ingolstadt north=Deggendorf west=Mannheim south=Freiburg
Bad Reichenhall north=Worms east=Peine west=Emmendingen south=Erfurt
Vechta north=Marienberg east=Wuppertal west=Meißen south=Magdeburg
Schwerin north=Meißen east=Magdeburg west=Landsberg
Magdeburg north=Vechta east=Dortmund west=Schwerin
Frankfurt east=Saarbrücken west=Aurich south=Marburg
Hannover north=Jena east=Brake south=Bergheim
Aurich east=Frankfurt west=Hofeck south=Stralsund
Stralsund north=Aurich east=Marburg west=Donauwörth south=Coburg
Weißenburg north=Brake east=Cologne west=Bergheim south=Nienburg
Duisburg north=Cottbus east=Deggendorf west=Oldenburg south=Mannheim
Mannheim north=Duisburg east=Ingolstadt west=Altchemnitz south=Schwandorf
Bielefeld east=Pirmasens west=Osnabrück south=Rostock
Mainz east=Berlin west=Pirmasens south=Mindelheim
Altchemnitz north=Oldenburg east=Mannheim west=Kirchheimbolanden south=Ulm
Lüchow north=Braunschweig east=Koblenz west=Wuppertal south=Wiesbaden
Düsseldorf north=Lübeck west=Münster
Rosenheim north=Pirna east=Aichach west=Tauberbischofsheim south=Düren
Korbach north=Nienburg east=Göttingen west=Frankfurt (Oder) south=Gießen
Biberach north=Frankfurt (Oder) east=Gießen south=Hamburg
Wuppertal north=Bad Segeberg east=Lüchow west=Vechta south=Dortmund
Koblenz north=Dingolfing east=Siegen west=Lüchow south=Cham
Hamburg north=Biberach east=Bremen south=Traunstein
Fürth north=Schwandorf east=Hanau west=Dingolfing south=Siegen
Lübeck north=Hanau west=Siegen south=Düsseldorf
Hofeck east=Aurich west=Berlin south=Donauwörth
Nordhorn north=Saarbrücken west=Marburg south=Trier
Aichach north=Coburg east=Cottbus west=Rosenheim south=Oldenburg
Nienburg north=Weißenburg east=Warendorf west=Karlsruhe south=Korbach
Görlitz north=Heidelberg east=Stuttgart west=Peine south=Bad Segeberg
Stuttgart north=Kirchheimbolanden east=Ulm west=Görlitz south=Braunschweig
Ulm north=Altchemnitz east=Schwandorf west=Stuttgart south=Dingolfing
Dingolfing north=Ulm east=Fürth west=Braunschweig south=Koblenz
Saarbrücken west=Frankfurt south=Nordhorn
Brake north=Munich east=Ludwigsburg west=Hannover south=Weißenburg
Trier north=Nordhorn west=Rotenburg south=Dresden
Beeskow north=Regen east=Gifhorn west=Warendorf south=Worms
Gifhorn north=Regensburg east=Neustadt west=Beeskow south=Kassel
Siegen north=Fürth east=Lübeck west=Koblenz south=Münster
Meiningen north=Traunstein east=Potsdam
Essen east=Osnabrück south=Jena
Cottbus north=Rotenburg east=Dresden west=Aichach south=Duisburg
Gießen north=Korbach east=Emmendingen west=Biberach south=Bremen
Schwandorf north=Mannheim east=Freiburg west=Ulm south=Fürth
Regen north=Künzelsau east=Regensburg west=Cologne south=Beeskow
Karlsruhe north=Bergheim east=Nienburg south=Frankfurt (Oder)
Warendorf north=Cologne east=Beeskow west=Nienburg south=Göttingen
Freiburg north=Ingolstadt west=Schwandorf south=Hanau
Potsdam north=Kitzingen east=Landsberg west=Meiningen
Marburg north=Frankfurt east=Nordhorn west=Stralsund south=Rotenburg
Künzelsau north=Nuremberg east=Husum west=Ludwigsburg south=Regen
Frankfurt (Oder) north=Karlsruhe east=Korbach south=Biberach
Cham north=Koblenz east=Münster west=Wiesbaden
